999999999999999999999999999999959
911111111191111111111911111119525
999991999991999999991999919999919
911111111111131111131111111111119
909999999939909999099999999999949
900000000000009119000000000000099
999999999939909919999990999999009
911111191119111111111190000000009
919999991919999919999999999999909
911111111911111111111111111111119
888881888888888818888888188888888
888881888888881111188888188888848
888881888888881111188888188888818
811111111111111101111111111111118
888888888888881111188888888888888
811111111111111111111111111111118
888888880888888818888888888888818
888888880888888818888888888888818
888888880888888818888888888888818
888888880888888818888888888888818
888888880888888818888888888888818
888888880888888818888888888888818
811111111111111111111111111111118
888888888888888818888888888888888
840000000000000010000000000000048
888888888888888888888888888888888
