444444444444444444444444444444454
400000000030000000000300000000314
433330333330333333330333303333304
400000000000300000030000000000004
403333333333303333033333333333334
400000000000003003000000000000004
433333333333303303333330333333334
400000030003003000000030000000004
403333330303333303333333333333304
400000000300000000000000000000004
444444444444444404444444444444444
444444444444440000044444444444444
444444444444440000044444444444444
444444444444440000044444444444444
444444444444440000044444444444444
444444444444444444444444444444444
