11111111111111111111111111111111111111111111111111111111111111111111111111111111111111111111111111111111111111111111111111111112
40000000000000000000000000000000000000000000000000000000000000000000000000000000000000000000000000000000000000000000000000000002
40555555555555555555555555555555555555555555555555555555555550055555555555555555555555555555555555555555555555555555555555555552
40000000000000000000000000000000000000000000000000000000000000000000000000000000000000000000000000000000000000000000000000000002
40555555555555555055555555555555555555550555555555555555555555555555555555555555555555555555555555555555555555555555555555555502
40600000000000005050000000000000000000000000000000000000000000000000000000000000000000000000000000000000000000000000000000000002
40666666666666605055555555555555555555555555555555555555555555555555555555555555555555555555555555555555555555555555555555555502
40000000000000605050000000000000000000000000000000000000000000000000000000000000000000000000000000000000000000000000000000000002
46666666606666650500000000000000000000000000000000000000000000000000000000000000000000000000000000000000000000000000000000000002
40000000000000005550000000000000000000000000000000000000000000000000000000000000000000000000000000000000000000000000000000000002
40000000000000000000000000000000000000000000000000000000000000000000000000000000000000000000000000000000000000000000000000000002
40000000000000000000000000000000000000000000000000000000000000000000000000000000000000000000000000000000000000000000000000000002
40000000000000000000000000000000000000000000000000000000000000000000000000000000000000000000000000000000000000000000000000000002
40000000000000000000000000000000000000000000000000000000000000000000000000000000000000000000000000000000000000000000000000000002
40000000000000000000000000000000000000000000000000000000000000000000000000000000000000000000000000000000000000000000000000000002
40000000000000000000000000000000000000222200022222222222222222222000000000000000000000000000000000000000000000000000000000000002
40000000000000000000000000000000000000200000000000000000000000002000000000000000000000000000000000000000000000000000000000000002
40000000000000000000000000000000000000200000000000000000000000002000000000000000000000000000000000000000000000000000000000000002
40000000000000000000000000000000000000200000022222222222222000002000000000000000000000000000000000000000000000000000000000000002
40000000000000000000000000000000000000200000022222222222222000002000000000000000000000000000000000000000000000000000000000000002
40000000000000000000000000000000000000200000022222222222222000002000000000000000000000000000000000000000000000000000000000000002
40000000000000000000000000000000000000200000000000000000000000002000000000000000000000000000000000000000000000000000000000000002
40000000000000000000000000000000000000200000000000000000000000002000000000000000000000000000000000000000000000000000000000000002
40000000000000000000000000000000000000200000000000000000000000002000000000000000000000000000000000000000000000000000000000000002
40000000000000000000000000000000000000200000000000000000000000002000000000000000000000000000000000000000000000000000000000000002
40000000000000000000000000000000000000222222222222222222222222222000000000000000000000000000000000000000000000000000000000000002
40000000000000000000000000000000000000000000000000000000000000000000000000000000000000000000000000000000000000000000000000000002
40000000000000000000000000000000000000000000000000000000000000000000000000000000000000000000000000000000000000000000000000000002
40000000000000000000000000000000000000000000000000000000000000000000000000000000000000000000000000000000000000000000000000000002
40000000000000000000000000000000000000000000000000000000000000000000000000000000000000000000000000000000000000000000000000000002
40000000000000000000000000000000000000000000000000000000000000000000000000000000000000000000000000000000000000000000000000000002
40000000000000000000000000000000000000000000000000000000000000000000000000000000000000000000000000000000000000000000000000000002
40000000000000000000000000000000000000000000000000000000000000000000000000000000000000000000000000000000000000000000000000000002
40000000000000000000000000000000000000000000000000000000000000000000000000000000000000000000000000000000000000000000000000000002
40000000000000000000000000000000000000000000000000000000000000000000000000000000000000000000000000000000000000000000000000000002
40000000000000000000000000000000000000000000000000000000000000000000000000000000000000000000000000000000000000000000000000000002
40000000000000000000000000000000000000000000000000033333333333333333333333333333333333333333333330000000000000000000000000000002
40000000000000000000000000000000000000000000000000000000000000000000000000000000000000000000000000000000000000000000000000000002
40000000000000000000000000000000000000000000000000000000000000000000000000000000000000000000000000000000000000000000000000000002
40000000000000000000000000000000000000000000000000000000000000000000000000000000000000000000000000000000000000000000000000000002
40000000000000000000000000000000000000000000000000000000000000000000000000000000000000000000000000000000000000000000000000000002
40000000000000000000000000000000000000000000000000000000000000000000000000000000000000000000000000000000000000000000000000000002
43333333333333333333333333333333333333333333333333333333333333333333333333333333333333333333333333333333333333333333333333333333
