444444444444444444444444444444454
400000000030000000000300000004515
433330333330333333330333303333304
400000000000600000060000000000004
403333333363303333033333333333324
400000000000003003000000000000034
433333333363303303333330333333004
400000030003003000000030000000004
403333330303333303333333333333304
400000000300000000000000000000004
444444444444444404444444444444443
444444444444440000044444444444424
444444444444440000044444444444404
444444444444440000000000000000004
444444444444440000044444444444444
444444444444444444444444444444444
